  
                
                
                
@@@@@@@@@@@@@@@@
@/   #  !      @
@    #         @
@    #    !    @
@@@@@@@@@@@@   @
@  #  !  #     @
@  #     #     @
@  @@@@@@@@@@@@@
@    #! #   D  @
@    #  #      @
@    #  #      @
@@@@@@@@@@@@@@@@
