
         
@@@@@@@@@@@@@@@@
@      p!   #  @
@      #    #  @
@  /   #    p  @
@      #       @
@##############@
@!      @     !@
@       @      @
@##############@
@!      @  !  D@
@       @      @
@@@@@@@@@@@@@@@@

