
@@@@@@@@@@@@@@@@
@#   !  ##   !#@
@#@ @ @#@ @ @ @@
@### ###### # #@
@ @ p@p@ @  !@ @
@ /  #    #   #@
@ @#@#@ @#@ @ @@
@## ### p##  # @
@ @ @ @ @#@ @D@@
@# # p #  #### @
@      ## p#   @
@   ## p#      @
@              @
@      ppp     @
@@@@@@@@@@@@@@@@
